....... ...............................................
....... ........~~~~...................................
.......    .....~~~~...................................
.......................................................
........~~~~~~~~~......................................
.....................~.....~...........................
..................~~...................................
..................~~...................................
..................~~...................................
..................~~...................................
.............................~.....~...................
.......................................................
.................!!....................................
.......................................................
.............................~~~~~~~~~~................
.............................~~~~~~~~~~................
.......................................................
.......................................................
.......................................................
..................~~...................................
..................~~...................................
..................~~...................................
.............................~.....~...................
