....... ......................................................................................................
....... ........~~~~......................................................~~~~~~~~............................
.......    .....~~~~..........................................................................................
..............................................................................................................
........~~~~~~~~~...................................................................@.........................
.....................~.....~..................................................................................
........~~~~~~~~~.......~!@#...................................~~~~~~~~~......................................
.....................~.....~................................................~.....~...........................
..................~~.....................................................~~...................................
..................~~..........................@@.........................~~...................................
..................~~.....................................................~~...................................
..................~~.....................................................~~...................................
.............................~.....~................................................~.....~...................
..............................................................................................................
.................!!.....................................................!!....................................
..............................................................................................................
.............................~~~~~~~~~~@............................................~~~~~~~~~~................
.............................~~~~~~~~~~.............................................~~~~~~~~~~................
..............................................................................................................
..............................................................................................................
..............................................................................................................
..................~~.....................................................~~...................................
..................~~.....................................................~~...................................
.................!!.....................................................!!....................................
..............................................................................................................
.............................~~~~~~~~~~@............................................~~~~~~~~~~................
.............................~~~~~~~~~~.............................................~~~~~~~~~~................
..............................................................................................................
..............................................................................................................
..............................................................................................................
..................~~.....................................................~~...................................
..................~~.....................................................~~...................................
.................!!.....................................................!!....................................
..............................................................................................................
.............................~~~~~~~~~~@............................................~~~~~~~~~~................
.............................~~~~~~~~~~.............................................~~~~~~~~~~................
..............................................................................................................
..............................................................................................................
..............................................................................................................
..................~~.....................................................~~...................................
..................~~.....................................................~~...................................
